NO textures/fixed_simple.xpm
SO textures/fixed_simple.xpm
WE textures/fixed_simple.xpm
EA textures/fixed_simple.xpm
F 50,50,50
C 135,206,235

11111
10N01
11111
