NO ./textures/w1.xpm
SO ./textures/w2.xpm
WE ./textures/w3.xpm
EA ./textures/saincesu.xpm

F 123,123,1
C 35,68,79

1111111111111111111111111
1000000000110000000000001
1011000001110000000000001
1001000000000000000000001111111111111111111111111
1111111110110000011100000000000011111111111111111
1000000000110000011101111111111111111111111111111
11110111111111011100000010001
11110111111111011101010010001
11000000110101011100000010001
10000000000000001100000010001
1000000S000000001101010010001
11000001110101011111011110001
11110111111101011011110100011
11111111111111111111111111111

